11111
1P0C11
10001
1E001
11111