11111111
1P00C001
11111101
100C0101
101110C1
10C00001
1000E001
11111111