1111111111111111111111111
1PE000C000000C0000000C001
1111111111111111111111101
10000C00000000000C0000001
1011111111111111111111101
100000C000000000000000001
1111111111111111111111111