111111111111111
1P0000C00000001
101111111111101
101C00000000101
101011111110101
101010C00010101
101010111010101
1010C0000010C01
101111111110101
1E0000C000000C1
111111111111111