11111111111111111111
1P000C00000C00000001
11001111111111110C01
1000000000000000E001
11111111111111111111