11111111111111111111
1P000C00000C00000001
100011111111111100C1
1000000000000000E001
11111111111111111111