1111111111111111111111111
1P0000C000000C0000000C001
1011111111111111111111101
10000C00000000000C0000001
1011111111111111111111101
100000C0000000000000000E1
1111111111111111111111111